------------
---R--------
------------
-----@-G----
------------
-----------S
------------
------------
------------

----------R-
--G---------
---------G--
------------
-@----------
------------
---------G--
--S---------
------------

------------
-R----S-----
----S-------
-------S----
----@-------
------------
-------G----
---G--------
------------

----R-------
------------
---G--------
------------
-------RG---
----@-------
------------
-----S------
---------G--

